5
10
##########
E        #
## # #####
####     S
##########
