5
10
##########
I        #
#### #####
####     O
##########
