11
41
#########################################
#             #             ## ##       #
# ########### # ########### ## ## ##### #
I               #         # ## ## ## ## #
######################### #    ## ## ## #
O  ###            #    ## # ##### ## ## #
## # # ############ ## #  # ## ## ##    #
## # # #             # ## #       ## ## #
## # # # ############# ## ############# #
##       #                              #
#########################################
